#	bFlags(i)	pszName(s)	pSnd(p)
PS_WALK1	SFX_MISC	"Sfx\\Misc\\Walk1.wav"	NULL
PS_WALK2	SFX_MISC	"Sfx\\Misc\\Walk2.wav"	NULL
PS_WALK3	SFX_MISC	"Sfx\\Misc\\Walk3.wav"	NULL
PS_WALK4	SFX_MISC	"Sfx\\Misc\\Walk4.wav"	NULL
PS_BFIRE	SFX_MISC	"Sfx\\Misc\\BFire.wav"	NULL
PS_FMAG	SFX_MISC	"Sfx\\Misc\\Fmag.wav"	NULL
PS_TMAG	SFX_MISC	"Sfx\\Misc\\Tmag.wav"	NULL
PS_LGHIT	SFX_MISC	"Sfx\\Misc\\Lghit.wav"	NULL
PS_LGHIT1	SFX_MISC	"Sfx\\Misc\\Lghit1.wav"	NULL
PS_SWING	SFX_MISC	"Sfx\\Misc\\Swing.wav"	NULL
PS_SWING2	SFX_MISC	"Sfx\\Misc\\Swing2.wav"	NULL
PS_DEAD	SFX_MISC	"Sfx\\Misc\\Dead.wav"	NULL
IS_QUESTDN	SFX_STREAM	"Sfx\\Misc\\Questdon.wav"	NULL
IS_ARMRFKD	SFX_MISC	"Sfx\\Items\\Armrfkd.wav"	NULL
IS_BARLFIRE	SFX_MISC	"Sfx\\Items\\Barlfire.wav"	NULL
IS_BARREL	SFX_MISC	"Sfx\\Items\\Barrel.wav"	NULL
IS_BHIT	SFX_MISC	"Sfx\\Items\\Bhit.wav"	NULL
IS_BHIT1	SFX_MISC	"Sfx\\Items\\Bhit1.wav"	NULL
IS_CHEST	SFX_MISC	"Sfx\\Items\\Chest.wav"	NULL
IS_DOORCLOS	SFX_MISC	"Sfx\\Items\\Doorclos.wav"	NULL
IS_DOOROPEN	SFX_MISC	"Sfx\\Items\\Dooropen.wav"	NULL
IS_FANVL	SFX_MISC	"Sfx\\Items\\Flipanvl.wav"	NULL
IS_FAXE	SFX_MISC	"Sfx\\Items\\Flipaxe.wav"	NULL
IS_FBLST	SFX_MISC	"Sfx\\Items\\Flipblst.wav"	NULL
IS_FBODY	SFX_MISC	"Sfx\\Items\\Flipbody.wav"	NULL
IS_FBOOK	SFX_MISC	"Sfx\\Items\\Flipbook.wav"	NULL
IS_FBOW	SFX_MISC	"Sfx\\Items\\Flipbow.wav"	NULL
IS_FCAP	SFX_MISC	"Sfx\\Items\\Flipcap.wav"	NULL
IS_FHARM	SFX_MISC	"Sfx\\Items\\Flipharm.wav"	NULL
IS_FLARM	SFX_MISC	"Sfx\\Items\\Fliplarm.wav"	NULL
IS_FMAG	SFX_MISC	"Sfx\\Items\\Flipmag.wav"	NULL
IS_FMAG1	SFX_MISC	"Sfx\\Items\\Flipmag1.wav"	NULL
IS_FMUSH	SFX_MISC	"Sfx\\Items\\Flipmush.wav"	NULL
IS_FPOT	SFX_MISC	"Sfx\\Items\\Flippot.wav"	NULL
IS_FRING	SFX_MISC	"Sfx\\Items\\Flipring.wav"	NULL
IS_FROCK	SFX_MISC	"Sfx\\Items\\Fliprock.wav"	NULL
IS_FSCRL	SFX_MISC	"Sfx\\Items\\Flipscrl.wav"	NULL
IS_FSHLD	SFX_MISC	"Sfx\\Items\\Flipshld.wav"	NULL
IS_FSIGN	SFX_MISC	"Sfx\\Items\\Flipsign.wav"	NULL
IS_FSTAF	SFX_MISC	"Sfx\\Items\\Flipstaf.wav"	NULL
IS_FSWOR	SFX_MISC	"Sfx\\Items\\Flipswor.wav"	NULL
IS_GOLD	SFX_MISC	"Sfx\\Items\\Gold.wav"	NULL
IS_HLMTFKD	SFX_MISC	"Sfx\\Items\\Hlmtfkd.wav"	NULL
IS_IANVL	SFX_MISC	"Sfx\\Items\\Invanvl.wav"	NULL
IS_IAXE	SFX_MISC	"Sfx\\Items\\Invaxe.wav"	NULL
IS_IBLST	SFX_MISC	"Sfx\\Items\\Invblst.wav"	NULL
IS_IBODY	SFX_MISC	"Sfx\\Items\\Invbody.wav"	NULL
IS_IBOOK	SFX_MISC	"Sfx\\Items\\Invbook.wav"	NULL
IS_IBOW	SFX_MISC	"Sfx\\Items\\Invbow.wav"	NULL
IS_ICAP	SFX_MISC	"Sfx\\Items\\Invcap.wav"	NULL
IS_IGRAB	SFX_MISC	"Sfx\\Items\\Invgrab.wav"	NULL
IS_IHARM	SFX_MISC	"Sfx\\Items\\Invharm.wav"	NULL
IS_ILARM	SFX_MISC	"Sfx\\Items\\Invlarm.wav"	NULL
IS_IMUSH	SFX_MISC	"Sfx\\Items\\Invmush.wav"	NULL
IS_IPOT	SFX_MISC	"Sfx\\Items\\Invpot.wav"	NULL
IS_IRING	SFX_MISC	"Sfx\\Items\\Invring.wav"	NULL
IS_IROCK	SFX_MISC	"Sfx\\Items\\Invrock.wav"	NULL
IS_ISCROL	SFX_MISC	"Sfx\\Items\\Invscrol.wav"	NULL
IS_ISHIEL	SFX_MISC	"Sfx\\Items\\Invshiel.wav"	NULL
IS_ISIGN	SFX_MISC	"Sfx\\Items\\Invsign.wav"	NULL
IS_ISTAF	SFX_MISC	"Sfx\\Items\\Invstaf.wav"	NULL
IS_ISWORD	SFX_MISC	"Sfx\\Items\\Invsword.wav"	NULL
IS_LEVER	SFX_MISC	"Sfx\\Items\\Lever.wav"	NULL
IS_MAGIC	SFX_MISC	"Sfx\\Items\\Magic.wav"	NULL
IS_MAGIC1	SFX_MISC	"Sfx\\Items\\Magic1.wav"	NULL
IS_RBOOK	SFX_MISC	"Sfx\\Items\\Readbook.wav"	NULL
IS_SARC	SFX_MISC	"Sfx\\Items\\Sarc.wav"	NULL
IS_SHLDFKD	SFX_MISC	"Sfx\\Items\\Shielfkd.wav"	NULL
IS_SWRDFKD	SFX_MISC	"Sfx\\Items\\Swrdfkd.wav"	NULL
IS_TITLEMOV	SFX_UI	"Sfx\\Items\\Titlemov.wav"	NULL
IS_TITLSLCT	SFX_UI	"Sfx\\Items\\Titlslct.wav"	NULL
SFX_SILENCE	SFX_UI	"Sfx\\Misc\\blank.wav"	NULL
IS_TRAP	SFX_MISC	"Sfx\\Items\\Trap.wav"	NULL
IS_CAST1	SFX_MISC	"Sfx\\Misc\\Cast1.wav"	NULL
IS_CAST10	SFX_MISC	"Sfx\\Misc\\Cast10.wav"	NULL
IS_CAST12	SFX_MISC	"Sfx\\Misc\\Cast12.wav"	NULL
IS_CAST2	SFX_MISC	"Sfx\\Misc\\Cast2.wav"	NULL
IS_CAST3	SFX_MISC	"Sfx\\Misc\\Cast3.wav"	NULL
IS_CAST4	SFX_MISC	"Sfx\\Misc\\Cast4.wav"	NULL
IS_CAST5	SFX_MISC	"Sfx\\Misc\\Cast5.wav"	NULL
IS_CAST6	SFX_MISC	"Sfx\\Misc\\Cast6.wav"	NULL
IS_CAST7	SFX_MISC	"Sfx\\Misc\\Cast7.wav"	NULL
IS_CAST8	SFX_MISC	"Sfx\\Misc\\Cast8.wav"	NULL
IS_CAST9	SFX_MISC	"Sfx\\Misc\\Cast9.wav"	NULL
LS_HEALING	SFX_MISC	"Sfx\\Misc\\Healing.wav"	NULL
IS_REPAIR	SFX_MISC	"Sfx\\Misc\\Repair.wav"	NULL
LS_ACID	SFX_MISC	"Sfx\\Misc\\Acids1.wav"	NULL
LS_ACIDS	SFX_MISC	"Sfx\\Misc\\Acids2.wav"	NULL
LS_APOC	SFX_MISC	"Sfx\\Misc\\Apoc.wav"	NULL
LS_ARROWALL	SFX_MISC	"Sfx\\Misc\\Arrowall.wav"	NULL
LS_BLODBOIL	SFX_MISC	"Sfx\\Misc\\Bldboil.wav"	NULL
LS_BLODSTAR	SFX_MISC	"Sfx\\Misc\\Blodstar.wav"	NULL
LS_BLSIMPT	SFX_MISC	"Sfx\\Misc\\Blsimpt.wav"	NULL
LS_BONESP	SFX_MISC	"Sfx\\Misc\\Bonesp.wav"	NULL
LS_BSIMPCT	SFX_MISC	"Sfx\\Misc\\Bsimpct.wav"	NULL
LS_CALDRON	SFX_MISC	"Sfx\\Misc\\Caldron.wav"	NULL
LS_CBOLT	SFX_MISC	"Sfx\\Misc\\Cbolt.wav"	NULL
LS_CHLTNING	SFX_MISC	"Sfx\\Misc\\Chltning.wav"	NULL
LS_DSERP	SFX_MISC	"Sfx\\Misc\\DSerp.wav"	NULL
LS_ELECIMP1	SFX_MISC	"Sfx\\Misc\\Elecimp1.wav"	NULL
LS_ELEMENTL	SFX_MISC	"Sfx\\Misc\\Elementl.wav"	NULL
LS_ETHEREAL	SFX_MISC	"Sfx\\Misc\\Ethereal.wav"	NULL
LS_FBALL	SFX_MISC	"Sfx\\Misc\\Fball.wav"	NULL
LS_FBOLT1	SFX_MISC	"Sfx\\Misc\\Fbolt1.wav"	NULL
LS_FBOLT2	SFX_MISC	"Sfx\\Misc\\Fbolt2.wav"	NULL
LS_FIRIMP1	SFX_MISC	"Sfx\\Misc\\Firimp1.wav"	NULL
LS_FIRIMP2	SFX_MISC	"Sfx\\Misc\\Firimp2.wav"	NULL
LS_FLAMWAVE	SFX_MISC	"Sfx\\Misc\\Flamwave.wav"	NULL
LS_FLASH	SFX_MISC	"Sfx\\Misc\\Flash.wav"	NULL
LS_FOUNTAIN	SFX_MISC	"Sfx\\Misc\\Fountain.wav"	NULL
LS_GOLUM	SFX_MISC	"Sfx\\Misc\\Golum.wav"	NULL
LS_GOLUMDED	SFX_MISC	"Sfx\\Misc\\Golumded.wav"	NULL
LS_GSHRINE	SFX_MISC	"Sfx\\Misc\\Gshrine.wav"	NULL
LS_GUARD	SFX_MISC	"Sfx\\Misc\\Guard.wav"	NULL
LS_GUARDLAN	SFX_MISC	"Sfx\\Misc\\Grdlanch.wav"	NULL
LS_HOLYBOLT	SFX_MISC	"Sfx\\Misc\\Holybolt.wav"	NULL
LS_HYPER	SFX_MISC	"Sfx\\Misc\\Hyper.wav"	NULL
LS_INFRAVIS	SFX_MISC	"Sfx\\Misc\\Infravis.wav"	NULL
LS_INVISIBL	SFX_MISC	"Sfx\\Misc\\Invisibl.wav"	NULL
LS_INVPOT	SFX_MISC	"Sfx\\Misc\\Invpot.wav"	NULL
LS_LNING1	SFX_MISC	"Sfx\\Misc\\Lning1.wav"	NULL
LS_LTNING	SFX_MISC	"Sfx\\Misc\\Ltning.wav"	NULL
LS_MSHIELD	SFX_MISC	"Sfx\\Misc\\Mshield.wav"	NULL
LS_NOVA	SFX_MISC	"Sfx\\Misc\\Nova.wav"	NULL
LS_PORTAL	SFX_MISC	"Sfx\\Misc\\Portal.wav"	NULL
LS_PUDDLE	SFX_MISC	"Sfx\\Misc\\Puddle.wav"	NULL
LS_RESUR	SFX_MISC	"Sfx\\Misc\\Resur.wav"	NULL
LS_SCURSE	SFX_MISC	"Sfx\\Misc\\Scurse.wav"	NULL
LS_SCURIMP	SFX_MISC	"Sfx\\Misc\\Scurimp.wav"	NULL
LS_SENTINEL	SFX_MISC	"Sfx\\Misc\\Sentinel.wav"	NULL
LS_SHATTER	SFX_MISC	"Sfx\\Misc\\Shatter.wav"	NULL
LS_SOULFIRE	SFX_MISC	"Sfx\\Misc\\Soulfire.wav"	NULL
LS_SPOUTLOP	SFX_MISC	"Sfx\\Misc\\Spoutlop.wav"	NULL
LS_SPOUTSTR	SFX_MISC	"Sfx\\Misc\\Spoutstr.wav"	NULL
LS_STORM	SFX_MISC	"Sfx\\Misc\\Storm.wav"	NULL
LS_TRAPDIS	SFX_MISC	"Sfx\\Misc\\Trapdis.wav"	NULL
LS_TELEPORT	SFX_MISC	"Sfx\\Misc\\Teleport.wav"	NULL
LS_VTHEFT	SFX_MISC	"Sfx\\Misc\\Vtheft.wav"	NULL
LS_WALLLOOP	SFX_MISC	"Sfx\\Misc\\Wallloop.wav"	NULL
LS_WALLSTRT	SFX_MISC	"Sfx\\Misc\\Wallstrt.wav"	NULL
TSFX_BMAID1	SFX_STREAM	"Sfx\\Towners\\Bmaid01.wav"	NULL
TSFX_BMAID2	SFX_STREAM	"Sfx\\Towners\\Bmaid02.wav"	NULL
TSFX_BMAID3	SFX_STREAM	"Sfx\\Towners\\Bmaid03.wav"	NULL
TSFX_BMAID4	SFX_STREAM	"Sfx\\Towners\\Bmaid04.wav"	NULL
TSFX_BMAID5	SFX_STREAM	"Sfx\\Towners\\Bmaid05.wav"	NULL
TSFX_BMAID6	SFX_STREAM	"Sfx\\Towners\\Bmaid06.wav"	NULL
TSFX_BMAID7	SFX_STREAM	"Sfx\\Towners\\Bmaid07.wav"	NULL
TSFX_BMAID8	SFX_STREAM	"Sfx\\Towners\\Bmaid08.wav"	NULL
TSFX_BMAID9	SFX_STREAM	"Sfx\\Towners\\Bmaid09.wav"	NULL
TSFX_BMAID10	SFX_STREAM	"Sfx\\Towners\\Bmaid10.wav"	NULL
TSFX_BMAID11	SFX_STREAM	"Sfx\\Towners\\Bmaid11.wav"	NULL
TSFX_BMAID12	SFX_STREAM	"Sfx\\Towners\\Bmaid12.wav"	NULL
TSFX_BMAID13	SFX_STREAM	"Sfx\\Towners\\Bmaid13.wav"	NULL
TSFX_BMAID14	SFX_STREAM	"Sfx\\Towners\\Bmaid14.wav"	NULL
TSFX_BMAID15	SFX_STREAM	"Sfx\\Towners\\Bmaid15.wav"	NULL
TSFX_BMAID16	SFX_STREAM	"Sfx\\Towners\\Bmaid16.wav"	NULL
TSFX_BMAID17	SFX_STREAM	"Sfx\\Towners\\Bmaid17.wav"	NULL
TSFX_BMAID18	SFX_STREAM	"Sfx\\Towners\\Bmaid18.wav"	NULL
TSFX_BMAID19	SFX_STREAM	"Sfx\\Towners\\Bmaid19.wav"	NULL
TSFX_BMAID20	SFX_STREAM	"Sfx\\Towners\\Bmaid20.wav"	NULL
TSFX_BMAID21	SFX_STREAM	"Sfx\\Towners\\Bmaid21.wav"	NULL
TSFX_BMAID22	SFX_STREAM	"Sfx\\Towners\\Bmaid22.wav"	NULL
TSFX_BMAID23	SFX_STREAM	"Sfx\\Towners\\Bmaid23.wav"	NULL
TSFX_BMAID24	SFX_STREAM	"Sfx\\Towners\\Bmaid24.wav"	NULL
TSFX_BMAID25	SFX_STREAM	"Sfx\\Towners\\Bmaid25.wav"	NULL
TSFX_BMAID26	SFX_STREAM	"Sfx\\Towners\\Bmaid26.wav"	NULL
TSFX_BMAID27	SFX_STREAM	"Sfx\\Towners\\Bmaid27.wav"	NULL
TSFX_BMAID28	SFX_STREAM	"Sfx\\Towners\\Bmaid28.wav"	NULL
TSFX_BMAID29	SFX_STREAM	"Sfx\\Towners\\Bmaid29.wav"	NULL
TSFX_BMAID30	SFX_STREAM	"Sfx\\Towners\\Bmaid30.wav"	NULL
TSFX_BMAID31	SFX_STREAM	"Sfx\\Towners\\Bmaid31.wav"	NULL
TSFX_BMAID32	SFX_STREAM	"Sfx\\Towners\\Bmaid32.wav"	NULL
TSFX_BMAID33	SFX_STREAM	"Sfx\\Towners\\Bmaid33.wav"	NULL
TSFX_BMAID34	SFX_STREAM	"Sfx\\Towners\\Bmaid34.wav"	NULL
TSFX_BMAID35	SFX_STREAM	"Sfx\\Towners\\Bmaid35.wav"	NULL
TSFX_BMAID36	SFX_STREAM	"Sfx\\Towners\\Bmaid36.wav"	NULL
TSFX_BMAID37	SFX_STREAM	"Sfx\\Towners\\Bmaid37.wav"	NULL
TSFX_BMAID38	SFX_STREAM	"Sfx\\Towners\\Bmaid38.wav"	NULL
TSFX_BMAID39	SFX_STREAM	"Sfx\\Towners\\Bmaid39.wav"	NULL
TSFX_BMAID40	SFX_STREAM	"Sfx\\Towners\\Bmaid40.wav"	NULL
TSFX_SMITH1	SFX_STREAM	"Sfx\\Towners\\Bsmith01.wav"	NULL
TSFX_SMITH2	SFX_STREAM	"Sfx\\Towners\\Bsmith02.wav"	NULL
TSFX_SMITH3	SFX_STREAM	"Sfx\\Towners\\Bsmith03.wav"	NULL
TSFX_SMITH4	SFX_STREAM	"Sfx\\Towners\\Bsmith04.wav"	NULL
TSFX_SMITH5	SFX_STREAM	"Sfx\\Towners\\Bsmith05.wav"	NULL
TSFX_SMITH6	SFX_STREAM	"Sfx\\Towners\\Bsmith06.wav"	NULL
TSFX_SMITH7	SFX_STREAM	"Sfx\\Towners\\Bsmith07.wav"	NULL
TSFX_SMITH8	SFX_STREAM	"Sfx\\Towners\\Bsmith08.wav"	NULL
TSFX_SMITH9	SFX_STREAM	"Sfx\\Towners\\Bsmith09.wav"	NULL
TSFX_SMITH10	SFX_STREAM	"Sfx\\Towners\\Bsmith10.wav"	NULL
TSFX_SMITH11	SFX_STREAM	"Sfx\\Towners\\Bsmith11.wav"	NULL
TSFX_SMITH12	SFX_STREAM	"Sfx\\Towners\\Bsmith12.wav"	NULL
TSFX_SMITH13	SFX_STREAM	"Sfx\\Towners\\Bsmith13.wav"	NULL
TSFX_SMITH14	SFX_STREAM	"Sfx\\Towners\\Bsmith14.wav"	NULL
TSFX_SMITH15	SFX_STREAM	"Sfx\\Towners\\Bsmith15.wav"	NULL
TSFX_SMITH16	SFX_STREAM	"Sfx\\Towners\\Bsmith16.wav"	NULL
TSFX_SMITH17	SFX_STREAM	"Sfx\\Towners\\Bsmith17.wav"	NULL
TSFX_SMITH18	SFX_STREAM	"Sfx\\Towners\\Bsmith18.wav"	NULL
TSFX_SMITH19	SFX_STREAM	"Sfx\\Towners\\Bsmith19.wav"	NULL
TSFX_SMITH20	SFX_STREAM	"Sfx\\Towners\\Bsmith20.wav"	NULL
TSFX_SMITH21	SFX_STREAM	"Sfx\\Towners\\Bsmith21.wav"	NULL
TSFX_SMITH22	SFX_STREAM	"Sfx\\Towners\\Bsmith22.wav"	NULL
TSFX_SMITH23	SFX_STREAM	"Sfx\\Towners\\Bsmith23.wav"	NULL
TSFX_SMITH24	SFX_STREAM	"Sfx\\Towners\\Bsmith24.wav"	NULL
TSFX_SMITH25	SFX_STREAM	"Sfx\\Towners\\Bsmith25.wav"	NULL
TSFX_SMITH26	SFX_STREAM	"Sfx\\Towners\\Bsmith26.wav"	NULL
TSFX_SMITH27	SFX_STREAM	"Sfx\\Towners\\Bsmith27.wav"	NULL
TSFX_SMITH28	SFX_STREAM	"Sfx\\Towners\\Bsmith28.wav"	NULL
TSFX_SMITH29	SFX_STREAM	"Sfx\\Towners\\Bsmith29.wav"	NULL
TSFX_SMITH30	SFX_STREAM	"Sfx\\Towners\\Bsmith30.wav"	NULL
TSFX_SMITH31	SFX_STREAM	"Sfx\\Towners\\Bsmith31.wav"	NULL
TSFX_SMITH32	SFX_STREAM	"Sfx\\Towners\\Bsmith32.wav"	NULL
TSFX_SMITH33	SFX_STREAM	"Sfx\\Towners\\Bsmith33.wav"	NULL
TSFX_SMITH34	SFX_STREAM	"Sfx\\Towners\\Bsmith34.wav"	NULL
TSFX_SMITH35	SFX_STREAM	"Sfx\\Towners\\Bsmith35.wav"	NULL
TSFX_SMITH36	SFX_STREAM	"Sfx\\Towners\\Bsmith36.wav"	NULL
TSFX_SMITH37	SFX_STREAM	"Sfx\\Towners\\Bsmith37.wav"	NULL
TSFX_SMITH38	SFX_STREAM	"Sfx\\Towners\\Bsmith38.wav"	NULL
TSFX_SMITH39	SFX_STREAM	"Sfx\\Towners\\Bsmith39.wav"	NULL
TSFX_SMITH40	SFX_STREAM	"Sfx\\Towners\\Bsmith40.wav"	NULL
TSFX_SMITH41	SFX_STREAM	"Sfx\\Towners\\Bsmith41.wav"	NULL
TSFX_SMITH42	SFX_STREAM	"Sfx\\Towners\\Bsmith42.wav"	NULL
TSFX_SMITH43	SFX_STREAM	"Sfx\\Towners\\Bsmith43.wav"	NULL
TSFX_SMITH44	SFX_STREAM	"Sfx\\Towners\\Bsmith44.wav"	NULL
TSFX_SMITH45	SFX_STREAM	"Sfx\\Towners\\Bsmith45.wav"	NULL
TSFX_SMITH46	SFX_STREAM	"Sfx\\Towners\\Bsmith46.wav"	NULL
TSFX_SMITH47	SFX_STREAM	"Sfx\\Towners\\Bsmith47.wav"	NULL
TSFX_SMITH48	SFX_STREAM	"Sfx\\Towners\\Bsmith48.wav"	NULL
TSFX_SMITH49	SFX_STREAM	"Sfx\\Towners\\Bsmith49.wav"	NULL
TSFX_SMITH50	SFX_STREAM	"Sfx\\Towners\\Bsmith50.wav"	NULL
TSFX_SMITH51	SFX_STREAM	"Sfx\\Towners\\Bsmith51.wav"	NULL
TSFX_SMITH52	SFX_STREAM	"Sfx\\Towners\\Bsmith52.wav"	NULL
TSFX_SMITH53	SFX_STREAM	"Sfx\\Towners\\Bsmith53.wav"	NULL
TSFX_SMITH54	SFX_STREAM	"Sfx\\Towners\\Bsmith54.wav"	NULL
TSFX_SMITH55	SFX_STREAM	"Sfx\\Towners\\Bsmith55.wav"	NULL
TSFX_SMITH56	SFX_STREAM	"Sfx\\Towners\\Bsmith56.wav"	NULL
TSFX_COW1	0	"Sfx\\Towners\\Cow1.wav"	NULL
TSFX_COW2	0	"Sfx\\Towners\\Cow2.wav"	NULL
TSFX_DEADGUY	SFX_STREAM	"Sfx\\Towners\\Deadguy2.wav"	NULL
TSFX_DRUNK1	SFX_STREAM	"Sfx\\Towners\\Drunk01.wav"	NULL
TSFX_DRUNK2	SFX_STREAM	"Sfx\\Towners\\Drunk02.wav"	NULL
TSFX_DRUNK3	SFX_STREAM	"Sfx\\Towners\\Drunk03.wav"	NULL
TSFX_DRUNK4	SFX_STREAM	"Sfx\\Towners\\Drunk04.wav"	NULL
TSFX_DRUNK5	SFX_STREAM	"Sfx\\Towners\\Drunk05.wav"	NULL
TSFX_DRUNK6	SFX_STREAM	"Sfx\\Towners\\Drunk06.wav"	NULL
TSFX_DRUNK7	SFX_STREAM	"Sfx\\Towners\\Drunk07.wav"	NULL
TSFX_DRUNK8	SFX_STREAM	"Sfx\\Towners\\Drunk08.wav"	NULL
TSFX_DRUNK9	SFX_STREAM	"Sfx\\Towners\\Drunk09.wav"	NULL
TSFX_DRUNK10	SFX_STREAM	"Sfx\\Towners\\Drunk10.wav"	NULL
TSFX_DRUNK11	SFX_STREAM	"Sfx\\Towners\\Drunk11.wav"	NULL
TSFX_DRUNK12	SFX_STREAM	"Sfx\\Towners\\Drunk12.wav"	NULL
TSFX_DRUNK13	SFX_STREAM	"Sfx\\Towners\\Drunk13.wav"	NULL
TSFX_DRUNK14	SFX_STREAM	"Sfx\\Towners\\Drunk14.wav"	NULL
TSFX_DRUNK15	SFX_STREAM	"Sfx\\Towners\\Drunk15.wav"	NULL
TSFX_DRUNK16	SFX_STREAM	"Sfx\\Towners\\Drunk16.wav"	NULL
TSFX_DRUNK17	SFX_STREAM	"Sfx\\Towners\\Drunk17.wav"	NULL
TSFX_DRUNK18	SFX_STREAM	"Sfx\\Towners\\Drunk18.wav"	NULL
TSFX_DRUNK19	SFX_STREAM	"Sfx\\Towners\\Drunk19.wav"	NULL
TSFX_DRUNK20	SFX_STREAM	"Sfx\\Towners\\Drunk20.wav"	NULL
TSFX_DRUNK21	SFX_STREAM	"Sfx\\Towners\\Drunk21.wav"	NULL
TSFX_DRUNK22	SFX_STREAM	"Sfx\\Towners\\Drunk22.wav"	NULL
TSFX_DRUNK23	SFX_STREAM	"Sfx\\Towners\\Drunk23.wav"	NULL
TSFX_DRUNK24	SFX_STREAM	"Sfx\\Towners\\Drunk24.wav"	NULL
TSFX_DRUNK25	SFX_STREAM	"Sfx\\Towners\\Drunk25.wav"	NULL
TSFX_DRUNK26	SFX_STREAM	"Sfx\\Towners\\Drunk26.wav"	NULL
TSFX_DRUNK27	SFX_STREAM	"Sfx\\Towners\\Drunk27.wav"	NULL
TSFX_DRUNK28	SFX_STREAM	"Sfx\\Towners\\Drunk28.wav"	NULL
TSFX_DRUNK29	SFX_STREAM	"Sfx\\Towners\\Drunk29.wav"	NULL
TSFX_DRUNK30	SFX_STREAM	"Sfx\\Towners\\Drunk30.wav"	NULL
TSFX_DRUNK31	SFX_STREAM	"Sfx\\Towners\\Drunk31.wav"	NULL
TSFX_DRUNK32	SFX_STREAM	"Sfx\\Towners\\Drunk32.wav"	NULL
TSFX_DRUNK33	SFX_STREAM	"Sfx\\Towners\\Drunk33.wav"	NULL
TSFX_DRUNK34	SFX_STREAM	"Sfx\\Towners\\Drunk34.wav"	NULL
TSFX_DRUNK35	SFX_STREAM	"Sfx\\Towners\\Drunk35.wav"	NULL
TSFX_HEALER1	SFX_STREAM	"Sfx\\Towners\\Healer01.wav"	NULL
TSFX_HEALER2	SFX_STREAM	"Sfx\\Towners\\Healer02.wav"	NULL
TSFX_HEALER3	SFX_STREAM	"Sfx\\Towners\\Healer03.wav"	NULL
TSFX_HEALER4	SFX_STREAM	"Sfx\\Towners\\Healer04.wav"	NULL
TSFX_HEALER5	SFX_STREAM	"Sfx\\Towners\\Healer05.wav"	NULL
TSFX_HEALER6	SFX_STREAM	"Sfx\\Towners\\Healer06.wav"	NULL
TSFX_HEALER7	SFX_STREAM	"Sfx\\Towners\\Healer07.wav"	NULL
TSFX_HEALER8	SFX_STREAM	"Sfx\\Towners\\Healer08.wav"	NULL
TSFX_HEALER9	SFX_STREAM	"Sfx\\Towners\\Healer09.wav"	NULL
TSFX_HEALER10	SFX_STREAM	"Sfx\\Towners\\Healer10.wav"	NULL
TSFX_HEALER11	SFX_STREAM	"Sfx\\Towners\\Healer11.wav"	NULL
TSFX_HEALER12	SFX_STREAM	"Sfx\\Towners\\Healer12.wav"	NULL
TSFX_HEALER13	SFX_STREAM	"Sfx\\Towners\\Healer13.wav"	NULL
TSFX_HEALER14	SFX_STREAM	"Sfx\\Towners\\Healer14.wav"	NULL
TSFX_HEALER15	SFX_STREAM	"Sfx\\Towners\\Healer15.wav"	NULL
TSFX_HEALER16	SFX_STREAM	"Sfx\\Towners\\Healer16.wav"	NULL
TSFX_HEALER17	SFX_STREAM	"Sfx\\Towners\\Healer17.wav"	NULL
TSFX_HEALER18	SFX_STREAM	"Sfx\\Towners\\Healer18.wav"	NULL
TSFX_HEALER19	SFX_STREAM	"Sfx\\Towners\\Healer19.wav"	NULL
TSFX_HEALER20	SFX_STREAM	"Sfx\\Towners\\Healer20.wav"	NULL
TSFX_HEALER21	SFX_STREAM	"Sfx\\Towners\\Healer21.wav"	NULL
TSFX_HEALER22	SFX_STREAM	"Sfx\\Towners\\Healer22.wav"	NULL
TSFX_HEALER23	SFX_STREAM	"Sfx\\Towners\\Healer23.wav"	NULL
TSFX_HEALER24	SFX_STREAM	"Sfx\\Towners\\Healer24.wav"	NULL
TSFX_HEALER25	SFX_STREAM	"Sfx\\Towners\\Healer25.wav"	NULL
TSFX_HEALER26	SFX_STREAM	"Sfx\\Towners\\Healer26.wav"	NULL
TSFX_HEALER27	SFX_STREAM	"Sfx\\Towners\\Healer27.wav"	NULL
TSFX_HEALER28	SFX_STREAM	"Sfx\\Towners\\Healer28.wav"	NULL
TSFX_HEALER29	SFX_STREAM	"Sfx\\Towners\\Healer29.wav"	NULL
TSFX_HEALER30	SFX_STREAM	"Sfx\\Towners\\Healer30.wav"	NULL
TSFX_HEALER31	SFX_STREAM	"Sfx\\Towners\\Healer31.wav"	NULL
TSFX_HEALER32	SFX_STREAM	"Sfx\\Towners\\Healer32.wav"	NULL
TSFX_HEALER33	SFX_STREAM	"Sfx\\Towners\\Healer33.wav"	NULL
TSFX_HEALER34	SFX_STREAM	"Sfx\\Towners\\Healer34.wav"	NULL
TSFX_HEALER35	SFX_STREAM	"Sfx\\Towners\\Healer35.wav"	NULL
TSFX_HEALER36	SFX_STREAM	"Sfx\\Towners\\Healer36.wav"	NULL
TSFX_HEALER37	SFX_STREAM	"Sfx\\Towners\\Healer37.wav"	NULL
TSFX_HEALER38	SFX_STREAM	"Sfx\\Towners\\Healer38.wav"	NULL
TSFX_HEALER39	SFX_STREAM	"Sfx\\Towners\\Healer39.wav"	NULL
TSFX_HEALER40	SFX_STREAM	"Sfx\\Towners\\Healer40.wav"	NULL
TSFX_HEALER41	SFX_STREAM	"Sfx\\Towners\\Healer41.wav"	NULL
TSFX_HEALER42	SFX_STREAM	"Sfx\\Towners\\Healer42.wav"	NULL
TSFX_HEALER43	SFX_STREAM	"Sfx\\Towners\\Healer43.wav"	NULL
TSFX_HEALER44	SFX_STREAM	"Sfx\\Towners\\Healer44.wav"	NULL
TSFX_HEALER45	SFX_STREAM	"Sfx\\Towners\\Healer45.wav"	NULL
TSFX_HEALER46	SFX_STREAM	"Sfx\\Towners\\Healer46.wav"	NULL
TSFX_HEALER47	SFX_STREAM	"Sfx\\Towners\\Healer47.wav"	NULL
TSFX_PEGBOY1	SFX_STREAM	"Sfx\\Towners\\Pegboy01.wav"	NULL
TSFX_PEGBOY2	SFX_STREAM	"Sfx\\Towners\\Pegboy02.wav"	NULL
TSFX_PEGBOY3	SFX_STREAM	"Sfx\\Towners\\Pegboy03.wav"	NULL
TSFX_PEGBOY4	SFX_STREAM	"Sfx\\Towners\\Pegboy04.wav"	NULL
TSFX_PEGBOY5	SFX_STREAM	"Sfx\\Towners\\Pegboy05.wav"	NULL
TSFX_PEGBOY6	SFX_STREAM	"Sfx\\Towners\\Pegboy06.wav"	NULL
TSFX_PEGBOY7	SFX_STREAM	"Sfx\\Towners\\Pegboy07.wav"	NULL
TSFX_PEGBOY8	SFX_STREAM	"Sfx\\Towners\\Pegboy08.wav"	NULL
TSFX_PEGBOY9	SFX_STREAM	"Sfx\\Towners\\Pegboy09.wav"	NULL
TSFX_PEGBOY10	SFX_STREAM	"Sfx\\Towners\\Pegboy10.wav"	NULL
TSFX_PEGBOY11	SFX_STREAM	"Sfx\\Towners\\Pegboy11.wav"	NULL
TSFX_PEGBOY12	SFX_STREAM	"Sfx\\Towners\\Pegboy12.wav"	NULL
TSFX_PEGBOY13	SFX_STREAM	"Sfx\\Towners\\Pegboy13.wav"	NULL
TSFX_PEGBOY14	SFX_STREAM	"Sfx\\Towners\\Pegboy14.wav"	NULL
TSFX_PEGBOY15	SFX_STREAM	"Sfx\\Towners\\Pegboy15.wav"	NULL
TSFX_PEGBOY16	SFX_STREAM	"Sfx\\Towners\\Pegboy16.wav"	NULL
TSFX_PEGBOY17	SFX_STREAM	"Sfx\\Towners\\Pegboy17.wav"	NULL
TSFX_PEGBOY18	SFX_STREAM	"Sfx\\Towners\\Pegboy18.wav"	NULL
TSFX_PEGBOY19	SFX_STREAM	"Sfx\\Towners\\Pegboy19.wav"	NULL
TSFX_PEGBOY20	SFX_STREAM	"Sfx\\Towners\\Pegboy20.wav"	NULL
TSFX_PEGBOY21	SFX_STREAM	"Sfx\\Towners\\Pegboy21.wav"	NULL
TSFX_PEGBOY22	SFX_STREAM	"Sfx\\Towners\\Pegboy22.wav"	NULL
TSFX_PEGBOY23	SFX_STREAM	"Sfx\\Towners\\Pegboy23.wav"	NULL
TSFX_PEGBOY24	SFX_STREAM	"Sfx\\Towners\\Pegboy24.wav"	NULL
TSFX_PEGBOY25	SFX_STREAM	"Sfx\\Towners\\Pegboy25.wav"	NULL
TSFX_PEGBOY26	SFX_STREAM	"Sfx\\Towners\\Pegboy26.wav"	NULL
TSFX_PEGBOY27	SFX_STREAM	"Sfx\\Towners\\Pegboy27.wav"	NULL
TSFX_PEGBOY28	SFX_STREAM	"Sfx\\Towners\\Pegboy28.wav"	NULL
TSFX_PEGBOY29	SFX_STREAM	"Sfx\\Towners\\Pegboy29.wav"	NULL
TSFX_PEGBOY30	SFX_STREAM	"Sfx\\Towners\\Pegboy30.wav"	NULL
TSFX_PEGBOY31	SFX_STREAM	"Sfx\\Towners\\Pegboy31.wav"	NULL
TSFX_PEGBOY32	SFX_STREAM	"Sfx\\Towners\\Pegboy32.wav"	NULL
TSFX_PEGBOY33	SFX_STREAM	"Sfx\\Towners\\Pegboy33.wav"	NULL
TSFX_PEGBOY34	SFX_STREAM	"Sfx\\Towners\\Pegboy34.wav"	NULL
TSFX_PEGBOY35	SFX_STREAM	"Sfx\\Towners\\Pegboy35.wav"	NULL
TSFX_PEGBOY36	SFX_STREAM	"Sfx\\Towners\\Pegboy36.wav"	NULL
TSFX_PEGBOY37	SFX_STREAM	"Sfx\\Towners\\Pegboy37.wav"	NULL
TSFX_PEGBOY38	SFX_STREAM	"Sfx\\Towners\\Pegboy38.wav"	NULL
TSFX_PEGBOY39	SFX_STREAM	"Sfx\\Towners\\Pegboy39.wav"	NULL
TSFX_PEGBOY40	SFX_STREAM	"Sfx\\Towners\\Pegboy40.wav"	NULL
TSFX_PEGBOY41	SFX_STREAM	"Sfx\\Towners\\Pegboy41.wav"	NULL
TSFX_PEGBOY42	SFX_STREAM	"Sfx\\Towners\\Pegboy42.wav"	NULL
TSFX_PEGBOY43	SFX_STREAM	"Sfx\\Towners\\Pegboy43.wav"	NULL
TSFX_PRIEST0	SFX_STREAM	"Sfx\\Towners\\Priest00.wav"	NULL
TSFX_PRIEST1	SFX_STREAM	"Sfx\\Towners\\Priest01.wav"	NULL
TSFX_PRIEST2	SFX_STREAM	"Sfx\\Towners\\Priest02.wav"	NULL
TSFX_PRIEST3	SFX_STREAM	"Sfx\\Towners\\Priest03.wav"	NULL
TSFX_PRIEST4	SFX_STREAM	"Sfx\\Towners\\Priest04.wav"	NULL
TSFX_PRIEST5	SFX_STREAM	"Sfx\\Towners\\Priest05.wav"	NULL
TSFX_PRIEST6	SFX_STREAM	"Sfx\\Towners\\Priest06.wav"	NULL
TSFX_PRIEST7	SFX_STREAM	"Sfx\\Towners\\Priest07.wav"	NULL
TSFX_STORY0	SFX_STREAM	"Sfx\\Towners\\Storyt00.wav"	NULL
TSFX_STORY1	SFX_STREAM	"Sfx\\Towners\\Storyt01.wav"	NULL
TSFX_STORY2	SFX_STREAM	"Sfx\\Towners\\Storyt02.wav"	NULL
TSFX_STORY3	SFX_STREAM	"Sfx\\Towners\\Storyt03.wav"	NULL
TSFX_STORY4	SFX_STREAM	"Sfx\\Towners\\Storyt04.wav"	NULL
TSFX_STORY5	SFX_STREAM	"Sfx\\Towners\\Storyt05.wav"	NULL
TSFX_STORY6	SFX_STREAM	"Sfx\\Towners\\Storyt06.wav"	NULL
TSFX_STORY7	SFX_STREAM	"Sfx\\Towners\\Storyt07.wav"	NULL
TSFX_STORY8	SFX_STREAM	"Sfx\\Towners\\Storyt08.wav"	NULL
TSFX_STORY9	SFX_STREAM	"Sfx\\Towners\\Storyt09.wav"	NULL
TSFX_STORY10	SFX_STREAM	"Sfx\\Towners\\Storyt10.wav"	NULL
TSFX_STORY11	SFX_STREAM	"Sfx\\Towners\\Storyt11.wav"	NULL
TSFX_STORY12	SFX_STREAM	"Sfx\\Towners\\Storyt12.wav"	NULL
TSFX_STORY13	SFX_STREAM	"Sfx\\Towners\\Storyt13.wav"	NULL
TSFX_STORY14	SFX_STREAM	"Sfx\\Towners\\Storyt14.wav"	NULL
TSFX_STORY15	SFX_STREAM	"Sfx\\Towners\\Storyt15.wav"	NULL
TSFX_STORY16	SFX_STREAM	"Sfx\\Towners\\Storyt16.wav"	NULL
TSFX_STORY17	SFX_STREAM	"Sfx\\Towners\\Storyt17.wav"	NULL
TSFX_STORY18	SFX_STREAM	"Sfx\\Towners\\Storyt18.wav"	NULL
TSFX_STORY19	SFX_STREAM	"Sfx\\Towners\\Storyt19.wav"	NULL
TSFX_STORY20	SFX_STREAM	"Sfx\\Towners\\Storyt20.wav"	NULL
TSFX_STORY21	SFX_STREAM	"Sfx\\Towners\\Storyt21.wav"	NULL
TSFX_STORY22	SFX_STREAM	"Sfx\\Towners\\Storyt22.wav"	NULL
TSFX_STORY23	SFX_STREAM	"Sfx\\Towners\\Storyt23.wav"	NULL
TSFX_STORY24	SFX_STREAM	"Sfx\\Towners\\Storyt24.wav"	NULL
TSFX_STORY25	SFX_STREAM	"Sfx\\Towners\\Storyt25.wav"	NULL
TSFX_STORY26	SFX_STREAM	"Sfx\\Towners\\Storyt26.wav"	NULL
TSFX_STORY27	SFX_STREAM	"Sfx\\Towners\\Storyt27.wav"	NULL
TSFX_STORY28	SFX_STREAM	"Sfx\\Towners\\Storyt28.wav"	NULL
TSFX_STORY29	SFX_STREAM	"Sfx\\Towners\\Storyt29.wav"	NULL
TSFX_STORY30	SFX_STREAM	"Sfx\\Towners\\Storyt30.wav"	NULL
TSFX_STORY31	SFX_STREAM	"Sfx\\Towners\\Storyt31.wav"	NULL
TSFX_STORY32	SFX_STREAM	"Sfx\\Towners\\Storyt32.wav"	NULL
TSFX_STORY33	SFX_STREAM	"Sfx\\Towners\\Storyt33.wav"	NULL
TSFX_STORY34	SFX_STREAM	"Sfx\\Towners\\Storyt34.wav"	NULL
TSFX_STORY35	SFX_STREAM	"Sfx\\Towners\\Storyt35.wav"	NULL
TSFX_STORY36	SFX_STREAM	"Sfx\\Towners\\Storyt36.wav"	NULL
TSFX_STORY37	SFX_STREAM	"Sfx\\Towners\\Storyt37.wav"	NULL
TSFX_STORY38	SFX_STREAM	"Sfx\\Towners\\Storyt38.wav"	NULL
TSFX_TAVERN0	SFX_STREAM	"Sfx\\Towners\\Tavown00.wav"	NULL
TSFX_TAVERN1	SFX_STREAM	"Sfx\\Towners\\Tavown01.wav"	NULL
TSFX_TAVERN2	SFX_STREAM	"Sfx\\Towners\\Tavown02.wav"	NULL
TSFX_TAVERN3	SFX_STREAM	"Sfx\\Towners\\Tavown03.wav"	NULL
TSFX_TAVERN4	SFX_STREAM	"Sfx\\Towners\\Tavown04.wav"	NULL
TSFX_TAVERN5	SFX_STREAM	"Sfx\\Towners\\Tavown05.wav"	NULL
TSFX_TAVERN6	SFX_STREAM	"Sfx\\Towners\\Tavown06.wav"	NULL
TSFX_TAVERN7	SFX_STREAM	"Sfx\\Towners\\Tavown07.wav"	NULL
TSFX_TAVERN8	SFX_STREAM	"Sfx\\Towners\\Tavown08.wav"	NULL
TSFX_TAVERN9	SFX_STREAM	"Sfx\\Towners\\Tavown09.wav"	NULL
TSFX_TAVERN10	SFX_STREAM	"Sfx\\Towners\\Tavown10.wav"	NULL
TSFX_TAVERN11	SFX_STREAM	"Sfx\\Towners\\Tavown11.wav"	NULL
TSFX_TAVERN12	SFX_STREAM	"Sfx\\Towners\\Tavown12.wav"	NULL
TSFX_TAVERN13	SFX_STREAM	"Sfx\\Towners\\Tavown13.wav"	NULL
TSFX_TAVERN14	SFX_STREAM	"Sfx\\Towners\\Tavown14.wav"	NULL
TSFX_TAVERN15	SFX_STREAM	"Sfx\\Towners\\Tavown15.wav"	NULL
TSFX_TAVERN16	SFX_STREAM	"Sfx\\Towners\\Tavown16.wav"	NULL
TSFX_TAVERN17	SFX_STREAM	"Sfx\\Towners\\Tavown17.wav"	NULL
TSFX_TAVERN18	SFX_STREAM	"Sfx\\Towners\\Tavown18.wav"	NULL
TSFX_TAVERN19	SFX_STREAM	"Sfx\\Towners\\Tavown19.wav"	NULL
TSFX_TAVERN20	SFX_STREAM	"Sfx\\Towners\\Tavown20.wav"	NULL
TSFX_TAVERN21	SFX_STREAM	"Sfx\\Towners\\Tavown21.wav"	NULL
TSFX_TAVERN22	SFX_STREAM	"Sfx\\Towners\\Tavown22.wav"	NULL
TSFX_TAVERN23	SFX_STREAM	"Sfx\\Towners\\Tavown23.wav"	NULL
TSFX_TAVERN24	SFX_STREAM	"Sfx\\Towners\\Tavown24.wav"	NULL
TSFX_TAVERN25	SFX_STREAM	"Sfx\\Towners\\Tavown25.wav"	NULL
TSFX_TAVERN26	SFX_STREAM	"Sfx\\Towners\\Tavown26.wav"	NULL
TSFX_TAVERN27	SFX_STREAM	"Sfx\\Towners\\Tavown27.wav"	NULL
TSFX_TAVERN28	SFX_STREAM	"Sfx\\Towners\\Tavown28.wav"	NULL
TSFX_TAVERN29	SFX_STREAM	"Sfx\\Towners\\Tavown29.wav"	NULL
TSFX_TAVERN30	SFX_STREAM	"Sfx\\Towners\\Tavown30.wav"	NULL
TSFX_TAVERN31	SFX_STREAM	"Sfx\\Towners\\Tavown31.wav"	NULL
TSFX_TAVERN32	SFX_STREAM	"Sfx\\Towners\\Tavown32.wav"	NULL
TSFX_TAVERN33	SFX_STREAM	"Sfx\\Towners\\Tavown33.wav"	NULL
TSFX_TAVERN34	SFX_STREAM	"Sfx\\Towners\\Tavown34.wav"	NULL
TSFX_TAVERN35	SFX_STREAM	"Sfx\\Towners\\Tavown35.wav"	NULL
TSFX_TAVERN36	SFX_STREAM	"Sfx\\Towners\\Tavown36.wav"	NULL
TSFX_TAVERN37	SFX_STREAM	"Sfx\\Towners\\Tavown37.wav"	NULL
TSFX_TAVERN38	SFX_STREAM	"Sfx\\Towners\\Tavown38.wav"	NULL
TSFX_TAVERN39	SFX_STREAM	"Sfx\\Towners\\Tavown39.wav"	NULL
TSFX_TAVERN40	SFX_STREAM	"Sfx\\Towners\\Tavown40.wav"	NULL
TSFX_TAVERN41	SFX_STREAM	"Sfx\\Towners\\Tavown41.wav"	NULL
TSFX_TAVERN42	SFX_STREAM	"Sfx\\Towners\\Tavown42.wav"	NULL
TSFX_TAVERN43	SFX_STREAM	"Sfx\\Towners\\Tavown43.wav"	NULL
TSFX_TAVERN44	SFX_STREAM	"Sfx\\Towners\\Tavown44.wav"	NULL
TSFX_TAVERN45	SFX_STREAM	"Sfx\\Towners\\Tavown45.wav"	NULL
TSFX_WITCH1	SFX_STREAM	"Sfx\\Towners\\Witch01.wav"	NULL
TSFX_WITCH2	SFX_STREAM	"Sfx\\Towners\\Witch02.wav"	NULL
TSFX_WITCH3	SFX_STREAM	"Sfx\\Towners\\Witch03.wav"	NULL
TSFX_WITCH4	SFX_STREAM	"Sfx\\Towners\\Witch04.wav"	NULL
TSFX_WITCH5	SFX_STREAM	"Sfx\\Towners\\Witch05.wav"	NULL
TSFX_WITCH6	SFX_STREAM	"Sfx\\Towners\\Witch06.wav"	NULL
TSFX_WITCH7	SFX_STREAM	"Sfx\\Towners\\Witch07.wav"	NULL
TSFX_WITCH8	SFX_STREAM	"Sfx\\Towners\\Witch08.wav"	NULL
TSFX_WITCH9	SFX_STREAM	"Sfx\\Towners\\Witch09.wav"	NULL
TSFX_WITCH10	SFX_STREAM	"Sfx\\Towners\\Witch10.wav"	NULL
TSFX_WITCH11	SFX_STREAM	"Sfx\\Towners\\Witch11.wav"	NULL
TSFX_WITCH12	SFX_STREAM	"Sfx\\Towners\\Witch12.wav"	NULL
TSFX_WITCH13	SFX_STREAM	"Sfx\\Towners\\Witch13.wav"	NULL
TSFX_WITCH14	SFX_STREAM	"Sfx\\Towners\\Witch14.wav"	NULL
TSFX_WITCH15	SFX_STREAM	"Sfx\\Towners\\Witch15.wav"	NULL
TSFX_WITCH16	SFX_STREAM	"Sfx\\Towners\\Witch16.wav"	NULL
TSFX_WITCH17	SFX_STREAM	"Sfx\\Towners\\Witch17.wav"	NULL
TSFX_WITCH18	SFX_STREAM	"Sfx\\Towners\\Witch18.wav"	NULL
TSFX_WITCH19	SFX_STREAM	"Sfx\\Towners\\Witch19.wav"	NULL
TSFX_WITCH20	SFX_STREAM	"Sfx\\Towners\\Witch20.wav"	NULL
TSFX_WITCH21	SFX_STREAM	"Sfx\\Towners\\Witch21.wav"	NULL
TSFX_WITCH22	SFX_STREAM	"Sfx\\Towners\\Witch22.wav"	NULL
TSFX_WITCH23	SFX_STREAM	"Sfx\\Towners\\Witch23.wav"	NULL
TSFX_WITCH24	SFX_STREAM	"Sfx\\Towners\\Witch24.wav"	NULL
TSFX_WITCH25	SFX_STREAM	"Sfx\\Towners\\Witch25.wav"	NULL
TSFX_WITCH26	SFX_STREAM	"Sfx\\Towners\\Witch26.wav"	NULL
TSFX_WITCH27	SFX_STREAM	"Sfx\\Towners\\Witch27.wav"	NULL
TSFX_WITCH28	SFX_STREAM	"Sfx\\Towners\\Witch28.wav"	NULL
TSFX_WITCH29	SFX_STREAM	"Sfx\\Towners\\Witch29.wav"	NULL
TSFX_WITCH30	SFX_STREAM	"Sfx\\Towners\\Witch30.wav"	NULL
TSFX_WITCH31	SFX_STREAM	"Sfx\\Towners\\Witch31.wav"	NULL
TSFX_WITCH32	SFX_STREAM	"Sfx\\Towners\\Witch32.wav"	NULL
TSFX_WITCH33	SFX_STREAM	"Sfx\\Towners\\Witch33.wav"	NULL
TSFX_WITCH34	SFX_STREAM	"Sfx\\Towners\\Witch34.wav"	NULL
TSFX_WITCH35	SFX_STREAM	"Sfx\\Towners\\Witch35.wav"	NULL
TSFX_WITCH36	SFX_STREAM	"Sfx\\Towners\\Witch36.wav"	NULL
TSFX_WITCH37	SFX_STREAM	"Sfx\\Towners\\Witch37.wav"	NULL
TSFX_WITCH38	SFX_STREAM	"Sfx\\Towners\\Witch38.wav"	NULL
TSFX_WITCH39	SFX_STREAM	"Sfx\\Towners\\Witch39.wav"	NULL
TSFX_WITCH40	SFX_STREAM	"Sfx\\Towners\\Witch40.wav"	NULL
TSFX_WITCH41	SFX_STREAM	"Sfx\\Towners\\Witch41.wav"	NULL
TSFX_WITCH42	SFX_STREAM	"Sfx\\Towners\\Witch42.wav"	NULL
TSFX_WITCH43	SFX_STREAM	"Sfx\\Towners\\Witch43.wav"	NULL
TSFX_WITCH44	SFX_STREAM	"Sfx\\Towners\\Witch44.wav"	NULL
TSFX_WITCH45	SFX_STREAM	"Sfx\\Towners\\Witch45.wav"	NULL
TSFX_WITCH46	SFX_STREAM	"Sfx\\Towners\\Witch46.wav"	NULL
TSFX_WITCH47	SFX_STREAM	"Sfx\\Towners\\Witch47.wav"	NULL
TSFX_WITCH48	SFX_STREAM	"Sfx\\Towners\\Witch48.wav"	NULL
TSFX_WITCH49	SFX_STREAM	"Sfx\\Towners\\Witch49.wav"	NULL
TSFX_WITCH50	SFX_STREAM	"Sfx\\Towners\\Witch50.wav"	NULL
TSFX_WOUND	SFX_STREAM	"Sfx\\Towners\\Wound01.wav"	NULL
PS_MAGE1	SFX_STREAM | SFX_SORCEROR	"Sfx\\Sorceror\\Mage01.wav"	NULL
PS_MAGE2	SFX_STREAM | SFX_SORCEROR	"Sfx\\Sorceror\\Mage02.wav"	NULL
PS_MAGE3	SFX_STREAM | SFX_SORCEROR	"Sfx\\Sorceror\\Mage03.wav"	NULL
PS_MAGE4	SFX_STREAM | SFX_SORCEROR	"Sfx\\Sorceror\\Mage04.wav"	NULL
PS_MAGE5	SFX_STREAM | SFX_SORCEROR	"Sfx\\Sorceror\\Mage05.wav"	NULL
PS_MAGE6	SFX_STREAM | SFX_SORCEROR	"Sfx\\Sorceror\\Mage06.wav"	NULL
PS_MAGE7	SFX_STREAM | SFX_SORCEROR	"Sfx\\Sorceror\\Mage07.wav"	NULL
PS_MAGE8	SFX_STREAM | SFX_SORCEROR	"Sfx\\Sorceror\\Mage08.wav"	NULL
PS_MAGE9	SFX_STREAM | SFX_SORCEROR	"Sfx\\Sorceror\\Mage09.wav"	NULL
PS_MAGE10	SFX_STREAM | SFX_SORCEROR	"Sfx\\Sorceror\\Mage10.wav"	NULL
PS_MAGE11	SFX_STREAM | SFX_SORCEROR	"Sfx\\Sorceror\\Mage11.wav"	NULL
PS_MAGE12	SFX_STREAM | SFX_SORCEROR	"Sfx\\Sorceror\\Mage12.wav"	NULL
PS_MAGE13	SFX_SORCEROR	"Sfx\\Sorceror\\Mage13.wav"	NULL
PS_MAGE14	SFX_SORCEROR	"Sfx\\Sorceror\\Mage14.wav"	NULL
PS_MAGE15	SFX_SORCEROR	"Sfx\\Sorceror\\Mage15.wav"	NULL
PS_MAGE16	SFX_SORCEROR	"Sfx\\Sorceror\\Mage16.wav"	NULL
PS_MAGE17	SFX_SORCEROR	"Sfx\\Sorceror\\Mage17.wav"	NULL
PS_MAGE18	SFX_SORCEROR	"Sfx\\Sorceror\\Mage18.wav"	NULL
PS_MAGE19	SFX_SORCEROR	"Sfx\\Sorceror\\Mage19.wav"	NULL
PS_MAGE20	SFX_SORCEROR	"Sfx\\Sorceror\\Mage20.wav"	NULL
PS_MAGE21	SFX_SORCEROR	"Sfx\\Sorceror\\Mage21.wav"	NULL
PS_MAGE22	SFX_SORCEROR	"Sfx\\Sorceror\\Mage22.wav"	NULL
PS_MAGE23	SFX_SORCEROR	"Sfx\\Sorceror\\Mage23.wav"	NULL
PS_MAGE24	SFX_SORCEROR	"Sfx\\Sorceror\\Mage24.wav"	NULL
PS_MAGE25	SFX_SORCEROR	"Sfx\\Sorceror\\Mage25.wav"	NULL
PS_MAGE26	SFX_SORCEROR	"Sfx\\Sorceror\\Mage26.wav"	NULL
PS_MAGE27	SFX_SORCEROR	"Sfx\\Sorceror\\Mage27.wav"	NULL
PS_MAGE28	SFX_SORCEROR	"Sfx\\Sorceror\\Mage28.wav"	NULL
PS_MAGE29	SFX_SORCEROR	"Sfx\\Sorceror\\Mage29.wav"	NULL
PS_MAGE30	SFX_SORCEROR	"Sfx\\Sorceror\\Mage30.wav"	NULL
PS_MAGE31	SFX_SORCEROR	"Sfx\\Sorceror\\Mage31.wav"	NULL
PS_MAGE32	SFX_SORCEROR	"Sfx\\Sorceror\\Mage32.wav"	NULL
PS_MAGE33	SFX_SORCEROR	"Sfx\\Sorceror\\Mage33.wav"	NULL
PS_MAGE34	SFX_SORCEROR	"Sfx\\Sorceror\\Mage34.wav"	NULL
PS_MAGE35	SFX_SORCEROR	"Sfx\\Sorceror\\Mage35.wav"	NULL
PS_MAGE36	SFX_SORCEROR	"Sfx\\Sorceror\\Mage36.wav"	NULL
PS_MAGE37	SFX_SORCEROR	"Sfx\\Sorceror\\Mage37.wav"	NULL
PS_MAGE38	SFX_SORCEROR	"Sfx\\Sorceror\\Mage38.wav"	NULL
PS_MAGE39	SFX_SORCEROR	"Sfx\\Sorceror\\Mage39.wav"	NULL
PS_MAGE40	SFX_SORCEROR	"Sfx\\Sorceror\\Mage40.wav"	NULL
PS_MAGE41	SFX_SORCEROR	"Sfx\\Sorceror\\Mage41.wav"	NULL
PS_MAGE42	SFX_SORCEROR	"Sfx\\Sorceror\\Mage42.wav"	NULL
PS_MAGE43	SFX_SORCEROR	"Sfx\\Sorceror\\Mage43.wav"	NULL
PS_MAGE44	SFX_SORCEROR	"Sfx\\Sorceror\\Mage44.wav"	NULL
PS_MAGE45	SFX_SORCEROR	"Sfx\\Sorceror\\Mage45.wav"	NULL
PS_MAGE46	SFX_SORCEROR	"Sfx\\Sorceror\\Mage46.wav"	NULL
PS_MAGE47	SFX_SORCEROR	"Sfx\\Sorceror\\Mage47.wav"	NULL
PS_MAGE48	SFX_SORCEROR	"Sfx\\Sorceror\\Mage48.wav"	NULL
PS_MAGE49	SFX_SORCEROR	"Sfx\\Sorceror\\Mage49.wav"	NULL
PS_MAGE50	SFX_SORCEROR	"Sfx\\Sorceror\\Mage50.wav"	NULL
PS_MAGE51	SFX_STREAM | SFX_SORCEROR	"Sfx\\Sorceror\\Mage51.wav"	NULL
PS_MAGE52	SFX_STREAM | SFX_SORCEROR	"Sfx\\Sorceror\\Mage52.wav"	NULL
PS_MAGE53	SFX_STREAM | SFX_SORCEROR	"Sfx\\Sorceror\\Mage53.wav"	NULL
PS_MAGE54	SFX_STREAM | SFX_SORCEROR	"Sfx\\Sorceror\\Mage54.wav"	NULL
PS_MAGE55	SFX_STREAM | SFX_SORCEROR	"Sfx\\Sorceror\\Mage55.wav"	NULL
PS_MAGE56	SFX_STREAM | SFX_SORCEROR	"Sfx\\Sorceror\\Mage56.wav"	NULL
PS_MAGE57	SFX_SORCEROR	"Sfx\\Sorceror\\Mage57.wav"	NULL
PS_MAGE58	SFX_STREAM | SFX_SORCEROR	"Sfx\\Sorceror\\Mage58.wav"	NULL
PS_MAGE59	SFX_STREAM | SFX_SORCEROR	"Sfx\\Sorceror\\Mage59.wav"	NULL
PS_MAGE60	SFX_STREAM | SFX_SORCEROR	"Sfx\\Sorceror\\Mage60.wav"	NULL
PS_MAGE61	SFX_STREAM | SFX_SORCEROR	"Sfx\\Sorceror\\Mage61.wav"	NULL
PS_MAGE62	SFX_STREAM | SFX_SORCEROR	"Sfx\\Sorceror\\Mage62.wav"	NULL
PS_MAGE63	SFX_STREAM | SFX_SORCEROR	"Sfx\\Sorceror\\Mage63.wav"	NULL
PS_MAGE64	SFX_SORCEROR	"Sfx\\Sorceror\\Mage64.wav"	NULL
PS_MAGE65	SFX_SORCEROR	"Sfx\\Sorceror\\Mage65.wav"	NULL
PS_MAGE66	SFX_SORCEROR	"Sfx\\Sorceror\\Mage66.wav"	NULL
PS_MAGE67	SFX_SORCEROR	"Sfx\\Sorceror\\Mage67.wav"	NULL
PS_MAGE68	SFX_SORCEROR	"Sfx\\Sorceror\\Mage68.wav"	NULL
PS_MAGE69	SFX_SORCEROR	"Sfx\\Sorceror\\Mage69.wav"	NULL
PS_MAGE69B	SFX_SORCEROR	"Sfx\\Sorceror\\Mage69b.wav"	NULL
PS_MAGE70	SFX_SORCEROR	"Sfx\\Sorceror\\Mage70.wav"	NULL
PS_MAGE71	SFX_SORCEROR	"Sfx\\Sorceror\\Mage71.wav"	NULL
PS_MAGE72	SFX_SORCEROR	"Sfx\\Sorceror\\Mage72.wav"	NULL
PS_MAGE73	SFX_SORCEROR	"Sfx\\Sorceror\\Mage73.wav"	NULL
PS_MAGE74	SFX_SORCEROR	"Sfx\\Sorceror\\Mage74.wav"	NULL
PS_MAGE75	SFX_SORCEROR	"Sfx\\Sorceror\\Mage75.wav"	NULL
PS_MAGE76	SFX_SORCEROR	"Sfx\\Sorceror\\Mage76.wav"	NULL
PS_MAGE77	SFX_SORCEROR	"Sfx\\Sorceror\\Mage77.wav"	NULL
PS_MAGE78	SFX_SORCEROR	"Sfx\\Sorceror\\Mage78.wav"	NULL
PS_MAGE79	SFX_SORCEROR	"Sfx\\Sorceror\\Mage79.wav"	NULL
PS_MAGE80	SFX_STREAM | SFX_SORCEROR	"Sfx\\Sorceror\\Mage80.wav"	NULL
PS_MAGE81	SFX_STREAM | SFX_SORCEROR	"Sfx\\Sorceror\\Mage81.wav"	NULL
PS_MAGE82	SFX_STREAM | SFX_SORCEROR	"Sfx\\Sorceror\\Mage82.wav"	NULL
PS_MAGE83	SFX_STREAM | SFX_SORCEROR	"Sfx\\Sorceror\\Mage83.wav"	NULL
PS_MAGE84	SFX_STREAM | SFX_SORCEROR	"Sfx\\Sorceror\\Mage84.wav"	NULL
PS_MAGE85	SFX_STREAM | SFX_SORCEROR	"Sfx\\Sorceror\\Mage85.wav"	NULL
PS_MAGE86	SFX_STREAM | SFX_SORCEROR	"Sfx\\Sorceror\\Mage86.wav"	NULL
PS_MAGE87	SFX_STREAM | SFX_SORCEROR	"Sfx\\Sorceror\\Mage87.wav"	NULL
PS_MAGE88	SFX_STREAM | SFX_SORCEROR	"Sfx\\Sorceror\\Mage88.wav"	NULL
PS_MAGE89	SFX_STREAM | SFX_SORCEROR	"Sfx\\Sorceror\\Mage89.wav"	NULL
PS_MAGE90	SFX_STREAM | SFX_SORCEROR	"Sfx\\Sorceror\\Mage90.wav"	NULL
PS_MAGE91	SFX_STREAM | SFX_SORCEROR	"Sfx\\Sorceror\\Mage91.wav"	NULL
PS_MAGE92	SFX_STREAM | SFX_SORCEROR	"Sfx\\Sorceror\\Mage92.wav"	NULL
PS_MAGE93	SFX_STREAM | SFX_SORCEROR	"Sfx\\Sorceror\\Mage93.wav"	NULL
PS_MAGE94	SFX_STREAM | SFX_SORCEROR	"Sfx\\Sorceror\\Mage94.wav"	NULL
PS_MAGE95	SFX_STREAM | SFX_SORCEROR	"Sfx\\Sorceror\\Mage95.wav"	NULL
PS_MAGE96	SFX_STREAM | SFX_SORCEROR	"Sfx\\Sorceror\\Mage96.wav"	NULL
PS_MAGE97	SFX_STREAM | SFX_SORCEROR	"Sfx\\Sorceror\\Mage97.wav"	NULL
PS_MAGE98	SFX_STREAM | SFX_SORCEROR	"Sfx\\Sorceror\\Mage98.wav"	NULL
PS_MAGE99	SFX_STREAM | SFX_SORCEROR	"Sfx\\Sorceror\\Mage99.wav"	NULL
PS_MAGE100	SFX_STREAM | SFX_SORCEROR	"Sfx\\Sorceror\\Mage100.wav"	NULL
PS_MAGE101	SFX_STREAM | SFX_SORCEROR	"Sfx\\Sorceror\\Mage101.wav"	NULL
PS_MAGE102	SFX_STREAM | SFX_SORCEROR	"Sfx\\Sorceror\\Mage102.wav"	NULL
PS_ROGUE1	SFX_STREAM | SFX_ROGUE	"Sfx\\Rogue\\Rogue01.wav"	NULL
PS_ROGUE2	SFX_STREAM | SFX_ROGUE	"Sfx\\Rogue\\Rogue02.wav"	NULL
PS_ROGUE3	SFX_STREAM | SFX_ROGUE	"Sfx\\Rogue\\Rogue03.wav"	NULL
PS_ROGUE4	SFX_STREAM | SFX_ROGUE	"Sfx\\Rogue\\Rogue04.wav"	NULL
PS_ROGUE5	SFX_STREAM | SFX_ROGUE	"Sfx\\Rogue\\Rogue05.wav"	NULL
PS_ROGUE6	SFX_STREAM | SFX_ROGUE	"Sfx\\Rogue\\Rogue06.wav"	NULL
PS_ROGUE7	SFX_STREAM | SFX_ROGUE	"Sfx\\Rogue\\Rogue07.wav"	NULL
PS_ROGUE8	SFX_STREAM | SFX_ROGUE	"Sfx\\Rogue\\Rogue08.wav"	NULL
PS_ROGUE9	SFX_STREAM | SFX_ROGUE	"Sfx\\Rogue\\Rogue09.wav"	NULL
PS_ROGUE10	SFX_STREAM | SFX_ROGUE	"Sfx\\Rogue\\Rogue10.wav"	NULL
PS_ROGUE11	SFX_STREAM | SFX_ROGUE	"Sfx\\Rogue\\Rogue11.wav"	NULL
PS_ROGUE12	SFX_STREAM | SFX_ROGUE	"Sfx\\Rogue\\Rogue12.wav"	NULL
PS_ROGUE13	SFX_ROGUE	"Sfx\\Rogue\\Rogue13.wav"	NULL
PS_ROGUE14	SFX_ROGUE	"Sfx\\Rogue\\Rogue14.wav"	NULL
PS_ROGUE15	SFX_ROGUE	"Sfx\\Rogue\\Rogue15.wav"	NULL
PS_ROGUE16	SFX_ROGUE	"Sfx\\Rogue\\Rogue16.wav"	NULL
PS_ROGUE17	SFX_ROGUE	"Sfx\\Rogue\\Rogue17.wav"	NULL
PS_ROGUE18	SFX_ROGUE	"Sfx\\Rogue\\Rogue18.wav"	NULL
PS_ROGUE19	SFX_ROGUE	"Sfx\\Rogue\\Rogue19.wav"	NULL
PS_ROGUE20	SFX_ROGUE	"Sfx\\Rogue\\Rogue20.wav"	NULL
PS_ROGUE21	SFX_ROGUE	"Sfx\\Rogue\\Rogue21.wav"	NULL
PS_ROGUE22	SFX_ROGUE	"Sfx\\Rogue\\Rogue22.wav"	NULL
PS_ROGUE23	SFX_ROGUE	"Sfx\\Rogue\\Rogue23.wav"	NULL
PS_ROGUE24	SFX_ROGUE	"Sfx\\Rogue\\Rogue24.wav"	NULL
PS_ROGUE25	SFX_ROGUE	"Sfx\\Rogue\\Rogue25.wav"	NULL
PS_ROGUE26	SFX_ROGUE	"Sfx\\Rogue\\Rogue26.wav"	NULL
PS_ROGUE27	SFX_ROGUE	"Sfx\\Rogue\\Rogue27.wav"	NULL
PS_ROGUE28	SFX_ROGUE	"Sfx\\Rogue\\Rogue28.wav"	NULL
PS_ROGUE29	SFX_ROGUE	"Sfx\\Rogue\\Rogue29.wav"	NULL
PS_ROGUE30	SFX_ROGUE	"Sfx\\Rogue\\Rogue30.wav"	NULL
PS_ROGUE31	SFX_ROGUE	"Sfx\\Rogue\\Rogue31.wav"	NULL
PS_ROGUE32	SFX_ROGUE	"Sfx\\Rogue\\Rogue32.wav"	NULL
PS_ROGUE33	SFX_ROGUE	"Sfx\\Rogue\\Rogue33.wav"	NULL
PS_ROGUE34	SFX_ROGUE	"Sfx\\Rogue\\Rogue34.wav"	NULL
PS_ROGUE35	SFX_ROGUE	"Sfx\\Rogue\\Rogue35.wav"	NULL
PS_ROGUE36	SFX_ROGUE	"Sfx\\Rogue\\Rogue36.wav"	NULL
PS_ROGUE37	SFX_ROGUE	"Sfx\\Rogue\\Rogue37.wav"	NULL
PS_ROGUE38	SFX_ROGUE	"Sfx\\Rogue\\Rogue38.wav"	NULL
PS_ROGUE39	SFX_ROGUE	"Sfx\\Rogue\\Rogue39.wav"	NULL
PS_ROGUE40	SFX_ROGUE	"Sfx\\Rogue\\Rogue40.wav"	NULL
PS_ROGUE41	SFX_ROGUE	"Sfx\\Rogue\\Rogue41.wav"	NULL
PS_ROGUE42	SFX_ROGUE	"Sfx\\Rogue\\Rogue42.wav"	NULL
PS_ROGUE43	SFX_ROGUE	"Sfx\\Rogue\\Rogue43.wav"	NULL
PS_ROGUE44	SFX_ROGUE	"Sfx\\Rogue\\Rogue44.wav"	NULL
PS_ROGUE45	SFX_ROGUE	"Sfx\\Rogue\\Rogue45.wav"	NULL
PS_ROGUE46	SFX_ROGUE	"Sfx\\Rogue\\Rogue46.wav"	NULL
PS_ROGUE47	SFX_ROGUE	"Sfx\\Rogue\\Rogue47.wav"	NULL
PS_ROGUE48	SFX_ROGUE	"Sfx\\Rogue\\Rogue48.wav"	NULL
PS_ROGUE49	SFX_ROGUE	"Sfx\\Rogue\\Rogue49.wav"	NULL
PS_ROGUE50	SFX_ROGUE	"Sfx\\Rogue\\Rogue50.wav"	NULL
PS_ROGUE51	SFX_STREAM | SFX_ROGUE	"Sfx\\Rogue\\Rogue51.wav"	NULL
PS_ROGUE52	SFX_STREAM | SFX_ROGUE	"Sfx\\Rogue\\Rogue52.wav"	NULL
PS_ROGUE53	SFX_STREAM | SFX_ROGUE	"Sfx\\Rogue\\Rogue53.wav"	NULL
PS_ROGUE54	SFX_STREAM | SFX_ROGUE	"Sfx\\Rogue\\Rogue54.wav"	NULL
PS_ROGUE55	SFX_STREAM | SFX_ROGUE	"Sfx\\Rogue\\Rogue55.wav"	NULL
PS_ROGUE56	SFX_STREAM | SFX_ROGUE	"Sfx\\Rogue\\Rogue56.wav"	NULL
PS_ROGUE57	SFX_ROGUE	"Sfx\\Rogue\\Rogue57.wav"	NULL
PS_ROGUE58	SFX_STREAM | SFX_ROGUE	"Sfx\\Rogue\\Rogue58.wav"	NULL
PS_ROGUE59	SFX_STREAM | SFX_ROGUE	"Sfx\\Rogue\\Rogue59.wav"	NULL
PS_ROGUE60	SFX_STREAM | SFX_ROGUE	"Sfx\\Rogue\\Rogue60.wav"	NULL
PS_ROGUE61	SFX_STREAM | SFX_ROGUE	"Sfx\\Rogue\\Rogue61.wav"	NULL
PS_ROGUE62	SFX_STREAM | SFX_ROGUE	"Sfx\\Rogue\\Rogue62.wav"	NULL
PS_ROGUE63	SFX_STREAM | SFX_ROGUE	"Sfx\\Rogue\\Rogue63.wav"	NULL
PS_ROGUE64	SFX_ROGUE	"Sfx\\Rogue\\Rogue64.wav"	NULL
PS_ROGUE65	SFX_ROGUE	"Sfx\\Rogue\\Rogue65.wav"	NULL
PS_ROGUE66	SFX_ROGUE	"Sfx\\Rogue\\Rogue66.wav"	NULL
PS_ROGUE67	SFX_ROGUE	"Sfx\\Rogue\\Rogue67.wav"	NULL
PS_ROGUE68	SFX_ROGUE	"Sfx\\Rogue\\Rogue68.wav"	NULL
PS_ROGUE69	SFX_ROGUE	"Sfx\\Rogue\\Rogue69.wav"	NULL
PS_ROGUE69B	SFX_ROGUE	"Sfx\\Rogue\\Rogue69b.wav"	NULL
PS_ROGUE70	SFX_ROGUE	"Sfx\\Rogue\\Rogue70.wav"	NULL
PS_ROGUE71	SFX_ROGUE	"Sfx\\Rogue\\Rogue71.wav"	NULL
PS_ROGUE72	SFX_ROGUE	"Sfx\\Rogue\\Rogue72.wav"	NULL
PS_ROGUE73	SFX_ROGUE	"Sfx\\Rogue\\Rogue73.wav"	NULL
PS_ROGUE74	SFX_ROGUE	"Sfx\\Rogue\\Rogue74.wav"	NULL
PS_ROGUE75	SFX_ROGUE	"Sfx\\Rogue\\Rogue75.wav"	NULL
PS_ROGUE76	SFX_ROGUE	"Sfx\\Rogue\\Rogue76.wav"	NULL
PS_ROGUE77	SFX_ROGUE	"Sfx\\Rogue\\Rogue77.wav"	NULL
PS_ROGUE78	SFX_ROGUE	"Sfx\\Rogue\\Rogue78.wav"	NULL
PS_ROGUE79	SFX_ROGUE	"Sfx\\Rogue\\Rogue79.wav"	NULL
PS_ROGUE80	SFX_STREAM | SFX_ROGUE	"Sfx\\Rogue\\Rogue80.wav"	NULL
PS_ROGUE81	SFX_STREAM | SFX_ROGUE	"Sfx\\Rogue\\Rogue81.wav"	NULL
PS_ROGUE82	SFX_STREAM | SFX_ROGUE	"Sfx\\Rogue\\Rogue82.wav"	NULL
PS_ROGUE83	SFX_STREAM | SFX_ROGUE	"Sfx\\Rogue\\Rogue83.wav"	NULL
PS_ROGUE84	SFX_STREAM | SFX_ROGUE	"Sfx\\Rogue\\Rogue84.wav"	NULL
PS_ROGUE85	SFX_STREAM | SFX_ROGUE	"Sfx\\Rogue\\Rogue85.wav"	NULL
PS_ROGUE86	SFX_STREAM | SFX_ROGUE	"Sfx\\Rogue\\Rogue86.wav"	NULL
PS_ROGUE87	SFX_STREAM | SFX_ROGUE	"Sfx\\Rogue\\Rogue87.wav"	NULL
PS_ROGUE88	SFX_STREAM | SFX_ROGUE	"Sfx\\Rogue\\Rogue88.wav"	NULL
PS_ROGUE89	SFX_STREAM | SFX_ROGUE	"Sfx\\Rogue\\Rogue89.wav"	NULL
PS_ROGUE90	SFX_STREAM | SFX_ROGUE	"Sfx\\Rogue\\Rogue90.wav"	NULL
PS_ROGUE91	SFX_STREAM | SFX_ROGUE	"Sfx\\Rogue\\Rogue91.wav"	NULL
PS_ROGUE92	SFX_STREAM | SFX_ROGUE	"Sfx\\Rogue\\Rogue92.wav"	NULL
PS_ROGUE93	SFX_STREAM | SFX_ROGUE	"Sfx\\Rogue\\Rogue93.wav"	NULL
PS_ROGUE94	SFX_STREAM | SFX_ROGUE	"Sfx\\Rogue\\Rogue94.wav"	NULL
PS_ROGUE95	SFX_STREAM | SFX_ROGUE	"Sfx\\Rogue\\Rogue95.wav"	NULL
PS_ROGUE96	SFX_STREAM | SFX_ROGUE	"Sfx\\Rogue\\Rogue96.wav"	NULL
PS_ROGUE97	SFX_STREAM | SFX_ROGUE	"Sfx\\Rogue\\Rogue97.wav"	NULL
PS_ROGUE98	SFX_STREAM | SFX_ROGUE	"Sfx\\Rogue\\Rogue98.wav"	NULL
PS_ROGUE99	SFX_STREAM | SFX_ROGUE	"Sfx\\Rogue\\Rogue99.wav"	NULL
PS_ROGUE100	SFX_STREAM | SFX_ROGUE	"Sfx\\Rogue\\Rogue100.wav"	NULL
PS_ROGUE101	SFX_STREAM | SFX_ROGUE	"Sfx\\Rogue\\Rogue101.wav"	NULL
PS_ROGUE102	SFX_STREAM | SFX_ROGUE	"Sfx\\Rogue\\Rogue102.wav"	NULL
PS_WARR1	SFX_STREAM | SFX_WARRIOR	"Sfx\\Warrior\\Warior01.wav"	NULL
PS_WARR2	SFX_STREAM | SFX_WARRIOR	"Sfx\\Warrior\\Warior02.wav"	NULL
PS_WARR3	SFX_STREAM | SFX_WARRIOR	"Sfx\\Warrior\\Warior03.wav"	NULL
PS_WARR4	SFX_STREAM | SFX_WARRIOR	"Sfx\\Warrior\\Warior04.wav"	NULL
PS_WARR5	SFX_STREAM | SFX_WARRIOR	"Sfx\\Warrior\\Warior05.wav"	NULL
PS_WARR6	SFX_STREAM | SFX_WARRIOR	"Sfx\\Warrior\\Warior06.wav"	NULL
PS_WARR7	SFX_STREAM | SFX_WARRIOR	"Sfx\\Warrior\\Warior07.wav"	NULL
PS_WARR8	SFX_STREAM | SFX_WARRIOR	"Sfx\\Warrior\\Warior08.wav"	NULL
PS_WARR9	SFX_STREAM | SFX_WARRIOR	"Sfx\\Warrior\\Warior09.wav"	NULL
PS_WARR10	SFX_STREAM | SFX_WARRIOR	"Sfx\\Warrior\\Warior10.wav"	NULL
PS_WARR11	SFX_STREAM | SFX_WARRIOR	"Sfx\\Warrior\\Warior11.wav"	NULL
PS_WARR12	SFX_STREAM | SFX_WARRIOR	"Sfx\\Warrior\\Warior12.wav"	NULL
PS_WARR13	SFX_WARRIOR	"Sfx\\Warrior\\Warior13.wav"	NULL
PS_WARR14	SFX_WARRIOR	"Sfx\\Warrior\\Warior14.wav"	NULL
PS_WARR14B	SFX_WARRIOR	"Sfx\\Warrior\\Wario14b.wav"	NULL
PS_WARR14C	SFX_WARRIOR	"Sfx\\Warrior\\Wario14c.wav"	NULL
PS_WARR15	SFX_WARRIOR	"Sfx\\Warrior\\Warior15.wav"	NULL
PS_WARR15B	SFX_WARRIOR	"Sfx\\Warrior\\Wario15b.wav"	NULL
PS_WARR15C	SFX_WARRIOR	"Sfx\\Warrior\\Wario15c.wav"	NULL
PS_WARR16	SFX_WARRIOR	"Sfx\\Warrior\\Warior16.wav"	NULL
PS_WARR16B	SFX_WARRIOR	"Sfx\\Warrior\\Wario16b.wav"	NULL
PS_WARR16C	SFX_WARRIOR	"Sfx\\Warrior\\Wario16c.wav"	NULL
PS_WARR17	SFX_WARRIOR	"Sfx\\Warrior\\Warior17.wav"	NULL
PS_WARR18	SFX_WARRIOR	"Sfx\\Warrior\\Warior18.wav"	NULL
PS_WARR19	SFX_WARRIOR	"Sfx\\Warrior\\Warior19.wav"	NULL
PS_WARR20	SFX_WARRIOR	"Sfx\\Warrior\\Warior20.wav"	NULL
PS_WARR21	SFX_WARRIOR	"Sfx\\Warrior\\Warior21.wav"	NULL
PS_WARR22	SFX_WARRIOR	"Sfx\\Warrior\\Warior22.wav"	NULL
PS_WARR23	SFX_WARRIOR	"Sfx\\Warrior\\Warior23.wav"	NULL
PS_WARR24	SFX_WARRIOR	"Sfx\\Warrior\\Warior24.wav"	NULL
PS_WARR25	SFX_WARRIOR	"Sfx\\Warrior\\Warior25.wav"	NULL
PS_WARR26	SFX_WARRIOR	"Sfx\\Warrior\\Warior26.wav"	NULL
PS_WARR27	SFX_WARRIOR	"Sfx\\Warrior\\Warior27.wav"	NULL
PS_WARR28	SFX_WARRIOR	"Sfx\\Warrior\\Warior28.wav"	NULL
PS_WARR29	SFX_WARRIOR	"Sfx\\Warrior\\Warior29.wav"	NULL
PS_WARR30	SFX_WARRIOR	"Sfx\\Warrior\\Warior30.wav"	NULL
PS_WARR31	SFX_WARRIOR	"Sfx\\Warrior\\Warior31.wav"	NULL
PS_WARR32	SFX_WARRIOR	"Sfx\\Warrior\\Warior32.wav"	NULL
PS_WARR33	SFX_WARRIOR	"Sfx\\Warrior\\Warior33.wav"	NULL
PS_WARR34	SFX_WARRIOR	"Sfx\\Warrior\\Warior34.wav"	NULL
PS_WARR35	SFX_WARRIOR	"Sfx\\Warrior\\Warior35.wav"	NULL
PS_WARR36	SFX_WARRIOR	"Sfx\\Warrior\\Warior36.wav"	NULL
PS_WARR37	SFX_WARRIOR	"Sfx\\Warrior\\Warior37.wav"	NULL
PS_WARR38	SFX_WARRIOR	"Sfx\\Warrior\\Warior38.wav"	NULL
PS_WARR39	SFX_WARRIOR	"Sfx\\Warrior\\Warior39.wav"	NULL
PS_WARR40	SFX_WARRIOR	"Sfx\\Warrior\\Warior40.wav"	NULL
PS_WARR41	SFX_WARRIOR	"Sfx\\Warrior\\Warior41.wav"	NULL
PS_WARR42	SFX_WARRIOR	"Sfx\\Warrior\\Warior42.wav"	NULL
PS_WARR43	SFX_WARRIOR	"Sfx\\Warrior\\Warior43.wav"	NULL
PS_WARR44	SFX_WARRIOR	"Sfx\\Warrior\\Warior44.wav"	NULL
PS_WARR45	SFX_WARRIOR	"Sfx\\Warrior\\Warior45.wav"	NULL
PS_WARR46	SFX_WARRIOR	"Sfx\\Warrior\\Warior46.wav"	NULL
PS_WARR47	SFX_WARRIOR	"Sfx\\Warrior\\Warior47.wav"	NULL
PS_WARR48	SFX_WARRIOR	"Sfx\\Warrior\\Warior48.wav"	NULL
PS_WARR49	SFX_WARRIOR	"Sfx\\Warrior\\Warior49.wav"	NULL
PS_WARR50	SFX_WARRIOR	"Sfx\\Warrior\\Warior50.wav"	NULL
PS_WARR51	SFX_STREAM | SFX_WARRIOR	"Sfx\\Warrior\\Warior51.wav"	NULL
PS_WARR52	SFX_STREAM | SFX_WARRIOR	"Sfx\\Warrior\\Warior52.wav"	NULL
PS_WARR53	SFX_STREAM | SFX_WARRIOR	"Sfx\\Warrior\\Warior53.wav"	NULL
PS_WARR54	SFX_STREAM | SFX_WARRIOR	"Sfx\\Warrior\\Warior54.wav"	NULL
PS_WARR55	SFX_STREAM | SFX_WARRIOR	"Sfx\\Warrior\\Warior55.wav"	NULL
PS_WARR56	SFX_STREAM | SFX_WARRIOR	"Sfx\\Warrior\\Warior56.wav"	NULL
PS_WARR57	SFX_WARRIOR	"Sfx\\Warrior\\Warior57.wav"	NULL
PS_WARR58	SFX_STREAM | SFX_WARRIOR	"Sfx\\Warrior\\Warior58.wav"	NULL
PS_WARR59	SFX_STREAM | SFX_WARRIOR	"Sfx\\Warrior\\Warior59.wav"	NULL
PS_WARR60	SFX_STREAM | SFX_WARRIOR	"Sfx\\Warrior\\Warior60.wav"	NULL
PS_WARR61	SFX_STREAM | SFX_WARRIOR	"Sfx\\Warrior\\Warior61.wav"	NULL
PS_WARR62	SFX_STREAM | SFX_WARRIOR	"Sfx\\Warrior\\Warior62.wav"	NULL
PS_WARR63	SFX_STREAM | SFX_WARRIOR	"Sfx\\Warrior\\Warior63.wav"	NULL
PS_WARR64	SFX_WARRIOR	"Sfx\\Warrior\\Warior64.wav"	NULL
PS_WARR65	SFX_WARRIOR	"Sfx\\Warrior\\Warior65.wav"	NULL
PS_WARR66	SFX_WARRIOR	"Sfx\\Warrior\\Warior66.wav"	NULL
PS_WARR67	SFX_WARRIOR	"Sfx\\Warrior\\Warior67.wav"	NULL
PS_WARR68	SFX_WARRIOR	"Sfx\\Warrior\\Warior68.wav"	NULL
PS_WARR69	SFX_WARRIOR	"Sfx\\Warrior\\Warior69.wav"	NULL
PS_WARR69B	SFX_WARRIOR	"Sfx\\Warrior\\Wario69b.wav"	NULL
PS_WARR70	SFX_WARRIOR	"Sfx\\Warrior\\Warior70.wav"	NULL
PS_WARR71	SFX_WARRIOR	"Sfx\\Warrior\\Warior71.wav"	NULL
PS_WARR72	SFX_WARRIOR	"Sfx\\Warrior\\Warior72.wav"	NULL
PS_WARR73	SFX_WARRIOR	"Sfx\\Warrior\\Warior73.wav"	NULL
PS_WARR74	SFX_WARRIOR	"Sfx\\Warrior\\Warior74.wav"	NULL
PS_WARR75	SFX_WARRIOR	"Sfx\\Warrior\\Warior75.wav"	NULL
PS_WARR76	SFX_WARRIOR	"Sfx\\Warrior\\Warior76.wav"	NULL
PS_WARR77	SFX_WARRIOR	"Sfx\\Warrior\\Warior77.wav"	NULL
PS_WARR78	SFX_WARRIOR	"Sfx\\Warrior\\Warior78.wav"	NULL
PS_WARR79	SFX_WARRIOR	"Sfx\\Warrior\\Warior79.wav"	NULL
PS_WARR80	SFX_STREAM | SFX_WARRIOR	"Sfx\\Warrior\\Warior80.wav"	NULL
PS_WARR81	SFX_STREAM | SFX_WARRIOR	"Sfx\\Warrior\\Warior81.wav"	NULL
PS_WARR82	SFX_STREAM | SFX_WARRIOR	"Sfx\\Warrior\\Warior82.wav"	NULL
PS_WARR83	SFX_STREAM | SFX_WARRIOR	"Sfx\\Warrior\\Warior83.wav"	NULL
PS_WARR84	SFX_STREAM | SFX_WARRIOR	"Sfx\\Warrior\\Warior84.wav"	NULL
PS_WARR85	SFX_STREAM | SFX_WARRIOR	"Sfx\\Warrior\\Warior85.wav"	NULL
PS_WARR86	SFX_STREAM | SFX_WARRIOR	"Sfx\\Warrior\\Warior86.wav"	NULL
PS_WARR87	SFX_STREAM | SFX_WARRIOR	"Sfx\\Warrior\\Warior87.wav"	NULL
PS_WARR88	SFX_STREAM | SFX_WARRIOR	"Sfx\\Warrior\\Warior88.wav"	NULL
PS_WARR89	SFX_STREAM | SFX_WARRIOR	"Sfx\\Warrior\\Warior89.wav"	NULL
PS_WARR90	SFX_STREAM | SFX_WARRIOR	"Sfx\\Warrior\\Warior90.wav"	NULL
PS_WARR91	SFX_STREAM | SFX_WARRIOR	"Sfx\\Warrior\\Warior91.wav"	NULL
PS_WARR92	SFX_STREAM | SFX_WARRIOR	"Sfx\\Warrior\\Warior92.wav"	NULL
PS_WARR93	SFX_STREAM | SFX_WARRIOR	"Sfx\\Warrior\\Warior93.wav"	NULL
PS_WARR94	SFX_STREAM | SFX_WARRIOR	"Sfx\\Warrior\\Warior94.wav"	NULL
PS_WARR95	SFX_STREAM | SFX_WARRIOR	"Sfx\\Warrior\\Warior95.wav"	NULL
PS_WARR95B	SFX_STREAM | SFX_WARRIOR	"Sfx\\Warrior\\Wario95b.wav"	NULL
PS_WARR95C	SFX_STREAM | SFX_WARRIOR	"Sfx\\Warrior\\Wario95c.wav"	NULL
PS_WARR95D	SFX_STREAM | SFX_WARRIOR	"Sfx\\Warrior\\Wario95d.wav"	NULL
PS_WARR95E	SFX_STREAM | SFX_WARRIOR	"Sfx\\Warrior\\Wario95e.wav"	NULL
PS_WARR95F	SFX_STREAM | SFX_WARRIOR	"Sfx\\Warrior\\Wario95f.wav"	NULL
PS_WARR96B	SFX_STREAM | SFX_WARRIOR	"Sfx\\Warrior\\Wario96b.wav"	NULL
PS_WARR97	SFX_STREAM | SFX_WARRIOR	"Sfx\\Warrior\\Wario97.wav"	NULL
PS_WARR98	SFX_STREAM | SFX_WARRIOR	"Sfx\\Warrior\\Wario98.wav"	NULL
PS_WARR99	SFX_STREAM | SFX_WARRIOR	"Sfx\\Warrior\\Warior99.wav"	NULL
PS_WARR100	SFX_STREAM | SFX_WARRIOR	"Sfx\\Warrior\\Wario100.wav"	NULL
PS_WARR101	SFX_STREAM | SFX_WARRIOR	"Sfx\\Warrior\\Wario101.wav"	NULL
PS_WARR102	SFX_STREAM | SFX_WARRIOR	"Sfx\\Warrior\\Wario102.wav"	NULL
PS_NAR1	SFX_STREAM	"Sfx\\Narrator\\Nar01.wav"	NULL
PS_NAR2	SFX_STREAM	"Sfx\\Narrator\\Nar02.wav"	NULL
PS_NAR3	SFX_STREAM	"Sfx\\Narrator\\Nar03.wav"	NULL
PS_NAR4	SFX_STREAM	"Sfx\\Narrator\\Nar04.wav"	NULL
PS_NAR5	SFX_STREAM	"Sfx\\Narrator\\Nar05.wav"	NULL
PS_NAR6	SFX_STREAM	"Sfx\\Narrator\\Nar06.wav"	NULL
PS_NAR7	SFX_STREAM	"Sfx\\Narrator\\Nar07.wav"	NULL
PS_NAR8	SFX_STREAM	"Sfx\\Narrator\\Nar08.wav"	NULL
PS_NAR9	SFX_STREAM	"Sfx\\Narrator\\Nar09.wav"	NULL
PS_DIABLVLINT	SFX_STREAM	"Sfx\\Misc\\Lvl16int.wav"	NULL
USFX_CLEAVER	SFX_STREAM	"Sfx\\Monsters\\Butcher.wav"	NULL
USFX_GARBUD1	SFX_STREAM	"Sfx\\Monsters\\Garbud01.wav"	NULL
USFX_GARBUD2	SFX_STREAM	"Sfx\\Monsters\\Garbud02.wav"	NULL
USFX_GARBUD3	SFX_STREAM	"Sfx\\Monsters\\Garbud03.wav"	NULL
USFX_GARBUD4	SFX_STREAM	"Sfx\\Monsters\\Garbud04.wav"	NULL
USFX_IZUAL1	SFX_STREAM	"Sfx\\Monsters\\Izual01.wav"	NULL
USFX_LACH1	SFX_STREAM	"Sfx\\Monsters\\Lach01.wav"	NULL
USFX_LACH2	SFX_STREAM	"Sfx\\Monsters\\Lach02.wav"	NULL
USFX_LACH3	SFX_STREAM	"Sfx\\Monsters\\Lach03.wav"	NULL
USFX_LAZ1	SFX_STREAM	"Sfx\\Monsters\\Laz01.wav"	NULL
USFX_LAZ2	SFX_STREAM	"Sfx\\Monsters\\Laz02.wav"	NULL
USFX_SKING1	SFX_STREAM	"Sfx\\Monsters\\Sking01.wav"	NULL
USFX_SNOT1	SFX_STREAM	"Sfx\\Monsters\\Snot01.wav"	NULL
USFX_SNOT2	SFX_STREAM	"Sfx\\Monsters\\Snot02.wav"	NULL
USFX_SNOT3	SFX_STREAM	"Sfx\\Monsters\\Snot03.wav"	NULL
USFX_WARLRD1	SFX_STREAM	"Sfx\\Monsters\\Warlrd01.wav"	NULL
USFX_WLOCK1	SFX_STREAM	"Sfx\\Monsters\\Wlock01.wav"	NULL
USFX_ZHAR1	SFX_STREAM	"Sfx\\Monsters\\Zhar01.wav"	NULL
USFX_ZHAR2	SFX_STREAM	"Sfx\\Monsters\\Zhar02.wav"	NULL
USFX_DIABLOD	SFX_STREAM	"Sfx\\Monsters\\DiabloD.wav"	NULL
